;
***€#***********T***
****#***************
*********T********O*
********************
***************T****
***T****************
********************
********T***********
*******TO********O**
O*******************
*******************T
***********O********
*****T**************
********************
**OO*****T**********
***************T****
********************
********************
**T*****O********&**
*****************&$*