xxxxxxxxxx
xxxx     x
x    xxx x
x xx xxx x
x        x
x xx xxx x
x xx xxx x
x xx xxx x
x        x
xxxxxxxxxx